©¥©×©¥©¥©¥©¥©¥©¥©¥©¥©¥©¥©¥©¥©×©¥©¥©¥©¥©×©¥©¥©¥©¥©¥©¥©¥©¥©¥©¥©¥©×©¥©¥©¥©¥©¥©¥©×©¥©¥©¥©¥©¥©¥©×©¥©¥©¥©¥©¥©×©¥©×©¥©¥©¥©¥©¥©¥©¥©¥©¥©¥©¥©¥©¥©×©¥©¥©¥©¥©×©¥©×©¥©¥©¥©¥©×©·
©§©§©³©¥©¥©¥©¥©¥©¥©×©¥©¥©¥©·©§©¥©×©·©§©»©¥©¥©¥©·©³©¥©×©¥©¥©¥©§©»©×©¥©¥©¥©³©·©»©×©¥©³©¥©¥©¥©§©¥©¥©·©³©¥©¿©§©§©³©¥©·©³©¥©³©¥©¥©×©¥©¥©×©¥©§©³©¥©³©·©§©§©Ç©¥©¥©³©·©§©§
©§©§©Ç©¥©³©¥©×©¥©·©»©¥©§©³©¿©Ç©·©§©§©»©·©³©¥©·©»©¿©§©§©¥©×©¥©ß©·©§©³©×©¥©¿©»©·©§©³©Ï©³©¥©¥©ß©¥©·©§©§©¥©¥©ï©¥©Ï©§©§©§©¥©Ï©¥©·©§©¥©·©§©¥©ï©¿©³©¿©»©×©¿©§©³©¥©¿©»©·©§
©Ç©¥©¿©§©§©§©§©§©§©³©¥©Ï©§©³©¿©§©§©»©·©»©Ï©§©»©×©¥©Ï©Ç©¥©§©³©¥©ß©¥©¿©§©¥©×©¥©Ç©¥©¿©§©§©¥©×©¥©·©»©Ï©»©¥©¥©§©§©§©§©§©»©×©ß©¥©§©»©·©»©ß©¥©§©¥©ï©¥©·©§©¥©¿©§©³©¥©×©¿©§
©§©¥©·©»©Ï©Ç©¥©Ï©§©§©§©»©¿©§©³©¥©·©³©ß©·©§©»©·©§©§©§©§©³©¿©§©³©¥©¥©·©»©¥©§©³©¿©³©¥©¥©ï©¥©§©¥©ï©¥©§©³©¥©·©§©§©§©§©Ç©·©§©³©¥©ß©·©»©¥©·©¥©Ï©§©§©§©§©Ç©¥©¥©¿©§©§©§©³©Ï
©Ç©¥©Ç©·©§©§©§©§©Ç©¿©Ç©¥©¥©ß©¿©§©»©Ï©§©»©×©¥©¿©Ç©¿©»©¥©ß©·©§©»©¥©§©»©×©¥©Ï©§©³©¿©³©¥©§©³©¿©§©§©³©¿©§©§©»©×©ï©¥©Ï©§©»©¥©Ï©³©¥©Ç©¥©¥©Ç©·©Ç©ß©·©§©§©§©§©¥©·©§©»©×©¿©§
©§©¥©¿©»©¥©Ï©»©×©¿©³©ß©¥©¥©·©³©ß©·©§©Ç©·©§©³©¥©¿©³©¥©×©¥©§©»©×©¥©ß©·©§©§©»©¥©ß©·©»©¥©×©Ï©¥©ï©¥©¿©¥©Ï©Ç©¥©§©§©§©§©Ç©¥©§©§©§©¥©Ï©¥©×©¿©§©§©§©»©¿©§©¥©ß©·©Ç©ß©¥©§©¥©Ï
©§©³©¥©¥©¥©ß©·©§©³©ß©¥©³©¥©§©§©¥©ß©¥©¿©»©¥©¿©³©¥©Ï©§©§©³©¥©·©»©¥©¥©§©»©¿©³©¥©·©»©×©¥©§©»©·©»©¥©¥©¥©Ï©§©¥©Ï©¥©Ï©§©§©¥©Ï©§©»©×©ß©¥©Ç©¥©×©¥©ß©¥©¥©ï©¥©¥©§©§©¥©¥©ï©¥©§
©§©§©³©¥©×©¥©§©§©»©·©³©ß©×©¥©ß©¥©¥©·©§©¥©×©¥©Ï©§©»©Ï©§©§©§©Ç©¥©¥©³©ß©¥©¥©Ï©§©»©·©§©³©¿©§©»©¥©×©¥©¥©§©Ç©·©»©·©»©×©ß©·©§©»©·©§©¥©¥©¿©§©»©·©³©¥©³©¿©³©¥©Ï©»©¥©·©§©§©§
©§©§©§©§©»©¥©¥©ß©¥©§©§©§©§©¥©¥©¥©·©Ç©ß©·©§©§©§©Ç©¥©§©§©§©§©»©·©¥©Ï©³©¥©·©§©§©§©Ç©×©¿©³©¿©§©³©¿©³©¥©¿©§©»©·©Ç©¥©§©§©§©Ç©¥©§©»©×©¥©·©Ç©¥©§©§©¥©Ï©³©¿©³©¿©³©¥©ß©¥©Ï©§
©§©§©§©Ç©×©¥©¥©¥©¥©Ï©¥©Ï©§©³©¥©¥©Ï©§©§©»©·©»©¥©Ï©¥©ï©¥©¿©Ç©¥©§©³©¿©§©§©»©×©Ï©§©§©§©³©Ï©³©ß©¿©³©Ï©¥©×©¿©§©§©»©¥©·©Ç©¥©ï©¥©×©¥©Ï©§©»©¿©³©ß©ß©¥©§©§©§©§©¥©¿©³©·©¥©¿©§
©§©Ç©¥©¿©§©³©¥©¥©·©»©·©Ç©×©¿©³©¥©§©§©»©·©»©·©³©ß©·©§©³©¥©Ï©¥©ß©¿©³©¿©Ç©¥©§©§©»©·©§©§©§©§©³©¥©Ï©§©§©»©×©¿©»©×©·©»©¿©§©§©§©§©§©§©Ç©¥©¥©Ï©¥©·©³©ß©¥©¿©Ç©¥©×©¿©»©×©¥©Ï
©§©»©·©¥©¥©Ï©¥©¥©Ï©¥©Ï©§©§©³©¿©¥©¿©Ç©·©Ç©·©»©¿©§©§©§©§©§©»©¥©¥©¥©ß©·©»©×©¥©»©·©»©ß©¥©Ç©¥©¿©¥©Ï©¥©ï©¥©§©¥©·©§©»©¥©¥©ï©¥©¿©§©»©¥©ß©·©§©§©§©»©Ï©¥©¥©×©¿©§©§©³©¥©§©§©§
©Ç©·©Ç©¥©¥©§©³©¥©»©·©»©·©§©»©×©¥©¥©§©§©§©»©×©¥©Ï©§©³©ß©Ï©³©¥©¥©¥©¥©§©§©»©¥©¥©ß©¥©¥©×©¿©¥©¥©·©§©³©¿©³©ß©·©»©×©¥©×©¥©§©¥©¥©ï©¥©¥©·©§©Ç©¥©ß©¥©Ç©¥©¥©Ç©¥©§©³©ß©·©§©§©§
©§©§©»©¥©·©»©Ï©³©·©»©·©§©Ç©·©Ç©¥©×©¥©ß©¥©³©¿©§©§©§©§©§©§©§©¥©×©¥©¥©ß©ß©·©³©¥©¥©¥©§©»©¥©¥©¥©Ï©§©§©¥©¿©§©»©·©§©§©§©³©ß©¥©¥©§©¥©·©§©§©§©¥©·©³©¿©³©×©¿©³©ß©Ï©§©»©×©Ï©§
©§©»©¥©·©»©·©§©§©»©·©»©×©¿©§©§©§©§©³©¥©¥©Ï©³©¿©§©Ç©¥©ß©¥©ß©·©§©¥©¥©¥©·©»©Ï©¥©¥©¥©ß©×©¥©×©¥©§©¥©ß©×©¥©ß©¥©§©§©§©§©§©³©×©¥©¿©§©§©§©§©»©·©Ç©¿©³©¿©§©§©§©§©§©»©·©§©§©§
©§©¥©·©Ç©¥©Ç©¥©¿©§©»©¥©§©§©»©¥©ß©×©¿©³©¥©§©Ç©¥©×©ß©·©¥©·©¥©¿©Ç©¥©¥©·©»©·©»©¥©·©³©¥©§©³©¿©³©ß©×©¥©§©¥©×©¥©Ï©³©¿©Ç©¿©§©§©¥©×©¿©Ç©¥©ß©·©§©§©¥©Ï©§©§©§©§©»©¥©×©¿©§©§©§
©§©§©Ç©¿©³©ß©¥©·©»©×©¥©Ï©Ç©¥©³©¥©§©¥©Ï©¥©¿©§©§©§©§©»©¥©ß©·©¥©Ï©¥©·©»©·©»©¥©·©»©¿©³©¿©§©³©Ï©¥©Ï©³©ï©¥©§©§©»©¿©³©¿©³©¿©³©¥©Ï©³©¿©¥©¥©Ï©§©»©¥©»©ß©¥©Ï©Ç©¥©¥©§©³©¿©³©Ï
©Ç©¿©§©¥©¿©³©·©»©·©§©³©¿©§©³©ß©¥©ß©·©»©¥©×©¿©§©§©Ç©¥©¥©·©Ç©¥©Ç©¥©Ç©·©»©·©§©»©¥©×©¿©³©¿©§©§©§©§©§©§©¥©Ï©»©×©¥©¿©³©ß©¥©Ï©§©§©Ç©¥©·©§©§©Ç©¥©×©¥©¥©·©§©§©¥©×©Ï©§©¥©¿©§
©§©¥©ß©¥©×©¿©»©·©§©§©§©¥©Ï©§©¥©×©¥©»©¥©·©§©³©Ï©§©§©³©¥©§©§©³©¿©³©¿©»©·©§©»©¥©·©»©·©§©³©¿©§©§©Ç©¥©Ç©¥©Ç©¥©§©¥©×©ß©¥©§©§©§©§©§©§©»©Ï©³©¿©§©§©§©¥©¿©§©»©·©§©§©Ç©×©¥©§
©§©³©¥©³©¿©§©§©§©§©»©¥©×©ß©¥©¥©Ï©³©¥©·©Ç©¥©¿©»©¥©ß©¿©³©¿©§©§©³©Ï©§©¥©¿©»©¥©·©»©·©§©¥©ß©·©³©Ï©§©¥©Ï©¥©Ï©³©ß©·©»©¥©³©ß©¥©Ï©»©¥©Ï©§©»©¿©¥©Ï©§©Ç©¥©¥©¿©§©»©¥©§©§©§©¥©Ï
©§©§©³©¿©³©¿©Ç©¿©Ç©¥©·©§©³©×©¥©§©§©§©§©Ç©¥©×©¥©¥©³©¥©§©³©ß©¥©Ï©§©»©×©¥©×©·©Ç©¥©¿©Ç©¥©¥©§©§©Ç©¥©·©»©·©§©§©§©»©×©¥©¿©¥©·©»©¥©·©»©ß©¥©¥©·©§©§©»©×©¥©¥©Ï©¥©×©¿©§©»©·©§
©§©§©§©¥©Ï©¥©¿©³©¿©§©»©×©¿©§©³©¿©³©¿©§©§©§©§©³©¥©Ç©¥©¿©§©§©¥©¿©³©×©¿©§©§©§©§©³©¥©Ï©¥©×©ß©¥©Ï©§©Ç©¥©Ï©Ç©¥©ß©·©§©³©¥©×©ß©¥©·©»©¥©¥©¥©·©»©¿©Ç©·©§©³©¥©§©³©¿©³©¿©§©§©§
©§©§©»©¥©Ç©¥©×©¿©³©ï©¥©§©¥©×©ß©¥©¿©³©¿©§©§©§©»©×©¿©³©¥©¿©Ç©¥©¥©¿©§©³©¿©Ç©¥©¥©¿©§©Ç©·©»©·©§©§©§©§©§©§©§©³©·©»©·©§©§©§©³©·©§©³©¥©¥©¥©»©¥©¥©¿©»©¥©Ï©³©ß©¿©³©Ï©¥©ß©Ï©§
©§©Ç©¥©¥©¿©§©§©¥©Ï©§©¥©ß©·©»©·©¥©×©ß©×©¥©Ï©§©§©§©¥©ß©·©¥©Ï©¥©·©³©¿©§©¥©Ï©¥©¥©×©¿©§©»©¥©§©Ç©×©ß©¥©ß©¥©¿©§©»©·©»©¿©§©§©§©§©§©§©§©³©¥©·©³©¥©×©¥©·©§©»©¥©³©Ï©§©³©¥©§©§
©§©§©§©³©¥©Ï©»©·©§©»©¥©·©»©¥©»©·©§©§©§©§©§©»©¿©»©×©¥©Ç©¥©Ç©¥©Ç©¿©³©ß©·©»©¥©³©¿©³©ß©¥©×©¥©Ï©§©¥©·©³©¥©¥©ß©·©»©×©¥©ß©×©¿©§©Ç©¿©Ç©¿©§©»©Ï©§©§©§©»©ß©×©¥©¿©§©¥©Ï©¥©Ï©§
©§©§©§©§©§©»©¥©§©»©·©§©»©×©¥©·©§©§©»©×©¿©Ç©¥©³©¥©¿©³©ß©·©§©§©§©¥©Ï©§©»©¥©×©Ï©¥©¿©¥©·©§©§©§©»©¥©§©§©³©×©¥©§©§©§©³©¥©¿©§©§©§©§©§©¥©ï©·©§©Ç©¥©ß©·©§©§©¥©·©»©·©»©·©§©§
©§©»©¿©§©Ç©¥©¥©ß©·©§©Ç©¥©§©§©Ç©¥©ß©·©§©¥©ß©¥©¿©§©³©¿©§©»©¥©ï©ß©¥©§©Ç©¥©·©§©Ç©¥©×©¥©Ï©§©§©Ç©¥©¥©¿©§©§©§©¥©Ï©Ç©¥©§©³©¥©ß©¥©Ï©»©ß©·©§©»©¥©Ï©³©¥©§©»©ß©¥©»©·©»©¥©§©§©§
©Ç©¥©¥©Ï©»©·©§©§©»©×©¿©³©¿©§©§©³©¥©§©»©¥©¥©×©¥©ß©¿©³©ß©×©¥©§©³©×©¿©§©§©»©·©§©³©¿©§©»©¥©¿©§©³©¥©¥©Ï©§©»©·©§©»©¥©¿©§©¥©¥©·©§©§©¥©ï©¥©¥©·©§©»©¥©ß©×©¥©¥©¥©Ï©³©¥©¿©§©§
©§©³©¥©Ç©·©»©Ï©»©·©»©·©§©³©ß©¥©Ï©¥©ß©·©¥©·©§©³©¥©¥©¿©§©§©³©¿©§©§©§©§©»©·©Ç©¥©¿©³©ï©¥©¥©¥©¿©§©¥©·©§©³©¥©¿©Ç©¥©·©¥©ß©¥©·©»©¿©»©·©§©§©¥©¿©Ç©¥©¥©¥©§©¥©×©¥©»©¿©§©³©¿©§
©§©§©¥©¿©»©·©»©¥©Ç©·©Ç©¿©§©§©¥©ß©¥©·©»©·©»©×©ß©¥©·©§©§©§©§©³©¿©³©¿©Ç©¥©§©§©¥©×©¿©§©³©·©§©³©ß©¥©»©×©¿©³©¥©¿©§©»©¥©×©¥©»©·©³©¥©Ï©§©»©×©¥©Ï©¥©¥©·©»©·©»©·©³©¥©ß©¿©³©Ï
©§©Ç©¥©¥©¥©»©¥©¥©¿©§©§©³©ß©ß©¥©·©¥©ï©¥©Ç©·©§©³©·©§©§©§©Ç©¥©ß©¥©¿©³©¿©³©¿©Ç©¥©§©¥©¿©§©§©»©¿©³©¥©×©¿©³©¿©³©¥©ï©¥©·©»©×©·©Ç©¿©§©§©»©·©»©·©§©¥©·©»©·©Ç©¥©Ç©¿©³©¥©¥©Ï©§
©§©Ç©¥©¥©×©¥©·©³©¥©ß©¥©¿©³©¥©·©»©¥©§©¥©Ï©§©§©§©§©»©¿©§©§©³©¥©³©¥©¿©³©Ï©¥©Ï©¥©Ï©¥©×©¿©»©¥©×©¿©§©§©¥©Ï©¥©¿©§©»©¥©Ç©¥©§©§©§©³©Ï©§©§©Ç©¥©§©»©·©»©·©Ç©¿©§©§©³©Ï©¥©·©§©§
©§©§©³©·©§©§©Ç©¿©³©¥©·©¥©ß©·©Ç©¥©¥©»©·©»©·©§©»©¥©·©³©ß©¥©ß©·©§©¥©¥©Ï©»©·©»©¥©Ç©·©§©³©×©¥©§©¥©Ï©»©·©»©¥©¥©ß©×©¥©§©¥©ß©·©§©§©»©¥©Ç©¿©³©¿©§©Ç©¥©§©§©¥©Ï©§©§©§©§©Ç©¥©Ï
©§©§©§©»©¥©Ï©§©¥©Ï©§©»©¥©¥©§©§©¥©×©×©ß©¥©§©»©¥©¥©Ç©¿©³©¥©·©Ç©ß©×©¥©§©§©»©×©¥©Ï©»©¥©¿©§©³©Ï©³©ß©·©»©¥©×©¥©¥©§©¥©ß©×©¥©Ç©¥©ß©·©³©¿©³©Ï©¥©Ï©§©³©¿©Ç©·©Ç©¿©§©¥©Ï©§©§©§
©§©¥©ï©¥©¥©»©¥©×©¿©Ç©¥©¥©¥©¿©»©·©§©§©¥©¥©ß©×©¥©¥©¿©³©¿©§©§©§©§©§©³©ß©¿©³©¿©§©§©³©¥©·©§©§©§©§©§©§©³©¥©¿©³©¥©Ç©¥©·©§©¥©¿©³©·©»©¿©³©¿©»©·©Ç©¥©¿©§©§©§©§©¥©Ï©³©ß©¥©Ï©§
©Ç©·©§©³©¥©¥©·©§©§©Ç©¥©·©¥©·©§©»©·©Ç©¥©¥©¥©§©³©¥©¥©¿©¥©Ï©»©×©ß©¥©¿©§©¥©¿©³©ß©×©¿©§©Ç©¥©Ï©¥©Ï©Ç©¥©§©¥©×©Ï©³©ß©¥©§©»©¥©×©¿©Ç©¥©¥©ß©¥©§©§©§©¥©¥©ß©·©§©Ç©¥©§©§©³©¥©§©§
©§©»©¥©¿©³©¥©¿©§©Ç©¿©§©»©¥©Ï©»©¥©Ï©§©¥©×©¥©Ï©»©¥©¥©·©§©Ç©¥©§©¥©¥©×©ß©¥©¥©¿©§©§©³©¿©§©¥©Ï©³©¿©§©¥©ï©¥©§©§©»©¥©§©»©¥©·©§©³©¿©§©§©³©¥©ï©¿©Ç©¥©×©¥©§©§©§©³©ß©¿©§©¥©Ï©§
©Ç©¥©³©¥©§©¥©×©Ï©§©¥©ï©¥©·©§©¥©·©§©»©·©»©·©§©³©¥©·©§©§©»©¥©ß©×©¥©Ç©¥©·©¥©·©»©¥©ß©·©»©·©§©§©¥©ï©¥©§©³©¿©»©¥©¥©¿©³©¥©¿©§©§©³©¿©Ç©¿©§©§©¥©¿©§©§©¥©Ï©Ç©¥©¿©³©¥©ß©·©§©§
©§©³©ß©¥©ß©·©§©»©¥©×©¿©§©§©Ç©·©§©»©¥©»©·©§©¥©Ï©§©§©Ç©ß©·©¥©·©§©³©¿©§©Ç©¥©Ï©¥©×©¥©Ç©·©»©×©ß©¥©§©³©¿©Ç©¥©·©¥©×©¥©¿©³©¥©¿©¥©Ï©¥©Ï©³©ß©×©¥©×©ß©Ï©§©»©Ï©³©·©§©§©¥©ï©¥©§
©§©§©¥©¥©·©§©§©§©§©§©¥©ï©¥©¿©§©Ç©¥©¥©×©¿©Ç©¥©§©»©Ï©§©§©»©·©»©¥©Ï©§©§©§©§©»©¥©¿©³©Ï©»©¥©§©³©×©¿©§©¥©Ï©§©»©×©¿©³©¥©Ï©³©¥©¥©Ï©§©§©»©¥©§©§©§©§©»©ß©·©§©§©§©»©ß©·©§©¥©Ï
©§©»©¥©¥©§©§©»©¿©§©Ç©¥©Ç©¥©³©¿©§©³©¥©§©¥©Ï©³©¿©§©»©¥©ß©·©Ç©¥©¥©§©§©»©×©ß©¥©¥©¥©¿©§©³©¥©¿©§©§©¥©ï©¥©§©»©·©§©³©¿©§©§©§©¥©·©Ç©ß©¥©¥©·©§©»©×©ß©×©¥©§©»©¥©Ç©¥©·©Ç©¥©·©§
©§©¥©×©¥©ß©¥©×©¥©ß©¿©³©¿©³©¿©¥©¿©§©¥©ï©·©§©»©·©»©¥©¥©·©§©»©¥©·©»©ï©¥©§©³©·©¥©¥©×©¿©§©³©¥©§©Ç©¥©§©³©ß©·©Ç©¥©Ï©¥©ß©¿©Ç©¥©§©§©³©¥©·©§©Ç©¥©§©§©§©³©ß©¥©×©¿©§©§©§©§©»©Ï
©Ç©·©Ç©¥©·©¥©Ï©³©¥©¥©¿©¥©¿©³©¥©×©ß©·©§©§©Ç©·©»©¥©·©³©¿©Ç©¥©·©»©·©§©³©Ï©§©»©×©¥©§©³©ß©¿©³©Ï©§©³©Ï©§©§©§©Ç©¥©§©³©¥©¥©¿©³©Ï©§©§©¥©Ï©§©§©³©¿©»©¥©¿©³©·©§©³©¿©§©¥©ï©·©§
©§©§©§©§©»©¥©§©§©³©¥©·©³©¥©Ï©§©§©§©§©³©¿©§©»©¥©¥©Ç©¿©³©¿©§©»©·©»©×©¿©Ç©¥©¥©§©¥©Ï©»©·©³©Ï©§©³©¿©Ç©¥©ß©¥©Ï©¥©Ï©§©¥©¥©×©¿©»©¥©ß©·©§©»©Ï©»©×©¥©¥©¥©Ï©»©×©¿©³©ß©·©§©§©§
©Ç©¥©×©ß©×©¥©¿©Ç©¿©§©Ç©¿©§©§©§©»©ï©¥©Ï©³©Ï©³©¥©×©¿©³©¿©³©ß©¥©Ç©¥©§©§©§©¥©¥©ß©·©»©·©§©§©§©³©¿©§©§©³©¥©§©»©·©§©»©¥©·©§©¥©¥©¥©·©§©Ç©·©§©§©»©·©³©¥©§©§©§©³©¿©¥©Ï©³©¿©§
©§©§©§©§©§©§©³©¿©³©Ï©§©¥©ï©¥©ß©¥©§©§©§©§©§©§©§©Ç©¥©§©³©ß©·©¥©¿©³©¿©§©»©×©¥©¥©Ç©¥©Ç©¥©¿©§©§©³©Ï©»©¿©³©ß©·©§©Ç©¥©¥©§©§©³©×©¥©Ç©·©§©§©Ç©ß©·©Ç©¿©³©¿©Ç©¥©¿©¥©·©§©§©¥©Ï
©§©»©¥©ï©¥©ï©¿©³©¿©Ç©¥©×©¿©³©¥©¥©§©Ç©¥©ß©×©¥©¿©§©§©§©§©§©»©¥©×©ß©¥©¿©³©¿©³©¥©Ï©¥©Ï©¥©¥©×©¿©§©»©¥©·©§©§©Ç©¥©Ï©¥©×©¿©§©§©§©¥©Ï©»©¥©§©§©§©§©§©¥©Ï©¥©Ï©³©¥©¥©ï©¥©ß©·©§
©§©¥©·©§©§©§©³©¿©§©§©§©§©¥©ß©¥©¥©¿©§©§©§©Ç©¥©·©§©§©Ç©¥©ï©×©¥©§©§©³©¥©§©¥©Ï©¥©ï©¥©Ç©¥©¥©§©§©§©¥©·©§©§©§©§©§©Ç©¥©§©³©ß©·©Ç©¥©Ç©¥©¥©ß©¥©ß©¥©ß©¥©»©·©§©§©¥©·©§©³©¥©§©§
©Ç©·©§©§©§©§©§©¥©ß©×©¿©»©¥©×©×©¥©×©ß©¿©§©§©§©»©¥©Ï©§©§©§©§©¥©ß©Ï©»©¥©ß©¥©»©·©§©¥©¿©³©¥©ß©Ï©»©·©»©×©¿©Ç©¥©Ï©§©³©¿©§©³©¿©§©§©§©¥©·©³©¥©¥©¥©×©¥©·©§©»©ß©·©»©×©ß©·©§©§
©§©§©Ç©¥©ß©¥©ï©¥©¥©¿©³©×©¥©§©§©§©§©§©§©Ç©¥©ß©×©¥©»©¥©ß©×©ß©¥©·©§©³©¥©¥©¥©·©§©»©¥©¥©ï©¥©§©»©¥©Ç©¥©¿©³©ß©¥©§©§©§©³©Ï©§©³©Ï©§©»©·©§©§©³©¥©·©§©§©§©»©¥©·©§©§©§©§©»©¥©Ï
©§©§©»©×©¥©§©§©³©¥©¥©¿©§©³©¿©§©»©×©Ï©§©§©³©·©»©¥©¥©¥©·©§©³©·©§©§©§©¥©×©¥©§©§©¥©×©¥©§©§©Ç©¥©×©¿©¥©¥©ß©·©§©Ç©¥©Ï©§©§©³©¿©§©»©¥©Ï©»©×©¿©§©»©·©§©»©×©·©§©»©Ï©§©»©¥©·©§
©§©»©¥©§©³©ß©×©¿©¥©·©³©¿©§©§©»©¥©§©§©Ç©¿©§©»©¥©¥©¥©·©Ç©¥©Ï©§©§©»©ß©¥©§©¥©Ï©Ç©¥©§©³©¿©§©§©§©§©³©¥©×©¥©§©Ç©¿©§©§©§©¥©ß©·©»©¥©·©»©¥©§©³©ï©¥©»©ß©¥©§©§©»©·©»©×©¥©×©¿©§
©§©¥©¥©¿©Ç©¥©§©¥©·©»©Ï©¥©ß©ß©¥©¥©·©§©§©¥©ß©¥©§©³©¥©¿©§©³©¿©³©Ï©¥©¥©×©ß©¥©§©§©¥©Ï©»©·©»©¿©Ç©¥©Ï©§©§©¥©×©¿©³©ß©¥©ß©¥©·©»©¥©¥©Ç©×©¥©¿©§©§©³©¥©¥©×©¿©»©¥©Ç©¥©§©§©§©§©§
©Ç©¥©×©¥©¿©§©Ç©¥©Ç©·©»©¥©¥©×©¥©·©»©Ï©³©¥©·©³©ß©¿©³©¥©Ï©§©³©¿©Ç©¥©¥©§©¥©×©¿©§©§©»©·©§©³©¥©Ï©§©§©§©»©¥©Ï©³©¿©¥©¥©×©¥©»©¥©¥©·©§©§©¥©¥©Ï©§©§©¥©·©»©·©³©¥©Ï©¥©¿©§©§©§©§
©§©§©§©§©¥©Ï©§©¥©¿©Ç©×©¥©§©§©§©»©¥©§©§©§©»©¿©³©¥©Ï©§©§©¥©ß©·©§©³©¥©ß©¥©§©³©ß©ß©¥©§©§©§©§©§©§©§©Ç©¥©¥©§©»©¥©·©§©»©×©¥©×©¥©ß©¥©Ç©¥©·©§©³©ß©·©»©·©§©»©¥©Ç©¥©¥©ß©¥©Ï©§
©§©»©¥©ï©·©Ç©ß©¥©¥©§©§©¥©ß©¿©Ç©¥©¥©ß©¿©Ç©¥©¥©¿©§©§©§©»©¥©·©»©¥©Ï©¥©¥©×©Ï©§©³©¥©×©¿©§©§©§©§©Ç©¥©Ï©³©¥©¿©¥©·©»©ß©·©§©§©§©³©¥©¥©ï©¥©§©»©Ï©§©§©³©¿©Ç©¥©¥©Ï©¥©·©¥©·©§©§
©Ç©¥©·©§©§©§©³©¥©¥©Ï©»©×©¥©×©ß©×©¥©·©³©¿©³©¥©·©Ç©¥©ß©¥©·©Ç©¥©·©»©·©§©§©»©¥©ï©¥©§©³©¿©»©¿©§©§©§©§©»©¥©¥©×©ß©·©§©»©·©Ç©¥©¿©¥©·©§©§©Ç©·©§©Ç©¥©Ï©³©¿©³©·©»©¥©Ç©·©Ç©¿©§
©§©§©§©§©»©¥©¿©³©·©§©§©§©§©§©§©§©§©§©§©§©§©§©§©§©¥©×©¥©§©»©¥©Ç©¥©§©§©»©·©§©§©§©§©»©×©¥©·©Ç©¥©Ï©»©¥©¥©·©§©§©Ç©ß©¥©§©»©¥©·©§©»©×©¿©§©»©¥©¿©§©§©§©³©¿©»©¥©¥©Ï©§©§©³©Ï
©§©»©¥©¿©³©¥©¥©¿©»©¥©ß©¥©ß©¥©¿©§©Ç©¥©¿©»©¿©§©»©ß©¥©§©¥©ß©¥©¥©¿©¥©ß©ß©¥©§©»©¥©ß©ß©¥©§©§©»©¿©§©»©¥©¥©¥©Ç©¥©¿©§©³©¥©ß©¥©¥©»©ß©¥©§©¥©ß©¥©¥©¥©¿©»©¥©ß©¥©¥©³©¥©§©»©¥©¿©§
©»©¥©¥©¥©ß©¥©¥©¥©¥©¥©¥©¥©¥©¥©¥©¥©ß©¥©¥©¥©¥©ß©¥©¥©¥©ß©¥©¥©¥©¥©¥©¥©¥©¥©¥©ß©¥©¥©¥©¥©¥©¥©ß©¥©¥©ß©¥©¥©¥©¥©ß©¥©¥©¥©ß©¥©¥©¥©¥©¥©¥©¥©ß©¥©¥©¥©¥©¥©¥©¥©¥©¥©¥©¥©ß©¥©¥©¥©¥©¥©¥
