©¥©¥©×©¥©¥©×©¥©¥©¥©¥©¥©¥©¥©×©¥©¥©¥©¥©¥©¥©×©¥©×©¥©¥©¥©×©¥©¥©¥©¥©¥©×©¥©¥©¥©¥©¥©¥©¥©·
©Ç©¥©§©¥©¥©¿©¥©·©³©¥©×©¥©·©»©×©¥©¥©³©¥©·©§©§©§©³©¥©·©§©³©·©³©¥©¥©¿©³©¥©·©³©¥©×©¥©Ï
©§©¥©Ï©³©¥©¥©×©¿©§©§©»©·©»©·©§©³©¥©¿©¥©Ï©»©Ï©§©§©§©Ç©¥©Ï©§©§©³©¥©¥©Ï©¥©Ï©§©§©§©§©§
©Ç©¥©§©»©·©§©§©¥©¿©Ç©·©§©§©§©§©Ç©¥©·©§©»©·©§©¥©¿©§©§©§©§©»©×©ß©¥©§©»©¥©»©¥©Ï©§©§©§
©§©¥©ß©·©»©¿©Ç©¥©¥©¿©§©»©ß©¥©¥©¿©§©§©Ç©·©§©»©¥©·©Ç©¥©Ï©§©§©§©³©¥©ß©¥©¥©×©¥©Ç©¥©Ï©§
©Ç©¥©·©»©×©¥©§©³©¥©·©»©¥©×©¥©·©¥©Ï©§©§©§©»©×©¥©Ç©¿©§©»©×©ß©×©¿©¥©×©·©¥©Ï©³©¿©§©§©§
©§©§©»©·©§©¥©ß©¿©§©§©§©³©¿©§©»©·©§©§©§©Ç©¥©§©³©¿©³©ß©·©§©§©»©¥©·©§©»©·©§©§©³©ß©¿©§
©§©Ç©¥©§©Ç©¥©×©¥©Ï©§©§©§©¥©ß©·©»©Ï©»©¥©Ï©§©§©Ç©¥©§©¥©ï©¥©ß©¥©·©»©×©¥©Ç©¥©¿©§©¥©·©§
©§©§©§©§©§©§©§©¥©¿©§©§©»©×©¥©Ç©·©»©¥©·©§©Ç©¿©§©³©¿©§©§©³©¥©§©»©·©§©¥©ß©¥©·©»©·©§©§
©§©§©»©ß©¥©Ï©»©·©¥©×©ß©×©¿©³©¿©»©¥©·©§©§©§©¥©¿©Ç©¥©Ï©¥©Ï©³©ß©¥©Ï©Ç©¥©×©·©§©³©¿©§©§
©§©»©×©¥©·©»©·©§©³©¿©§©§©³©¿©³©¥©³©ß©¥©¿©»©¥©×©¿©§©»©×©¿©§©¥©·©§©§©§©§©Ç©¥©§©³©¿©§
©Ç©¥©§©³©ß©·©§©»©¿©³©ß©¥©Ï©³©Ï©³©¿©³©¥©×©¥©§©§©³©ß©¥©§©¥©¿©³©¿©»©×©¿©§©§©³©Ï©»©¥©Ï
©Ç©¥©¥©Ï©§©§©»©×©¥©¿©³©¥©¿©§©§©§©¥©ß©¥©§©¥©ß©¥©Ï©¥©¥©ß©·©³©¿©³©·©§©¥©ß©·©§©»©¥©·©§
©§©³©¥©§©Ç©¥©¥©¿©³©¥©§©¥©¥©¿©§©§©³©¥©¥©ß©·©³©¥©Ç©¥©×©¥©»©Ï©³©¿©§©»©×©·©Ç©¥©¥©·©§©§
©§©§©³©¥©¿©³©¥©×©¿©§©»©·©³©¥©¿©§©§©¥©¥©·©»©¿©³©¿©§©»©¥©·©§©Ç©¥©×©¥©§©§©§©³©¥©§©§©§
©§©»©Ï©³©¥©¿©§©§©³©ß©¥©¿©§©¥©·©§©Ç©¥©·©»©¥©¥©¿©³©ß©·©§©§©§©§©§©§©¥©¿©Ç©¥©¿©³©ß©¿©§
©§©§©§©»©·©¥©ß©Ï©§©¥©×©¥©ß©·©§©§©§©¥©ß©¥©¥©¥©×©¿©§©»©¿©§©»©·©§©»©¥©·©§©¥©×©¿©¥©·©§
©§©§©»©·©»©×©¥©§©»©·©Ç©¥©³©¿©Ç©¿©§©³©¥©³©¥©×©¿©³©ï©¥©¥©ï©¥©Ç©ß©¥©¥©§©Ç©·©»©¥©·©»©Ï
©Ç©¿©³©ß©¥©§©³©ß©¥©§©§©§©§©¥©Ï©¥©ß©Ï©§©§©§©§©³©¿©§©§©³©¿©³©¿©³©¥©¥©Ï©§©Ç©¥©·©»©¥©§
©§©¥©Ï©¥©¥©¿©§©§©³©¿©§©»©ß©·©»©¥©¥©§©§©§©Ç©×©¿©¥©¿©§©§©¥©ß©¥©Ç©¥©·©»©¥©§©§©»©×©¥©§
©Ç©¥©»©·©³©¥©¿©§©§©¥©ß©¥©§©»©×©¥©×©¥©¿©§©§©§©¥©×©¥©Ï©³©¥©¥©¥©¿©§©»©¥©¥©Ï©§©¥©¿©³©Ï
©§©¥©×©¿©§©³©¥©ß©ß©¥©·©³©ß©·©§©§©Ç©¥©¥©Ï©§©³©¥©¿©§©Ç©¿©³©¥©¥©¥©ß©×©¥©·©§©Ç©¥©¥©¿©§
©§©§©§©³©Ï©§©¥©·©¥©×©¿©§©§©»©Ï©§©§©¥©·©§©Ç©¿©³©¥©Ï©§©³©ß©·©¥©×©¥©§©¥©ï©¥©ß©¥©³©¥©Ï
©§©»©×©¿©§©»©·©»©·©§©¥©Ï©»©·©§©§©»©¥©Ç©¥©§©¥©ß©·©»©×©¿©§©Ç©¥©§©³©¿©§©§©§©¥©·©§©§©§
©Ç©·©§©§©»©·©»©¥©§©Ç©¥©Ç©·©»©×©ß©¥©¥©¿©³©ß©¥©·©§©§©»©¥©§©§©³©Ï©»©·©Ç©¥©ß©·©»©¿©§©§
©§©§©§©»©×©ß©×©¥©¿©§©¥©¿©Ç©·©»©·©¥©×©¥©¿©§©¥©ß©¥©ï©¥©¥©Ï©§©§©»©·©»©¿©³©·©»©×©¥©Ï©§
©§©§©§©§©§©§©§©¥©·©Ç©¥©·©§©»©·©Ç©¥©¿©³©×©ß©¥©×©¥©§©¥©·©Ç©¥©¿©§©»©×©¥©¿©»©·©§©§©§©§
©§©³©ß©ß©¥©Ï©Ç©¥©Ç©¿©§©»©×©¥©§©§©³©×©¿©§©§©§©§©§©Ç©¥©§©§©§©¥©ß©·©§©³©·©¥©ß©×©¿©§©§
©§©§©¥©×©¥©§©§©¥©Ï©¥©ï©·©§©¥©ß©×©¿©§©³©¥©¿©Ç©¿©§©§©³©ß©¥©ï©¥©·©Ç©¿©§©»©·©³©¿©³©¿©§
©§©»©¥©§©¥©¿©»©·©»©¥©§©§©»©¥©¥©»©¥©¥©¿©³©¥©§©¥©ß©¿©»©¥©§©§©§©§©§©¥©¿©§©§©§©¥©¿©§©§
©»©¥©¥©ß©¥©¥©¥©ß©¥©¥©¥©ß©¥©¥©¥©¥©¥©¥©¥©ß©¥©ß©¥©¥©¥©¥©¥©ß©¥©ß©ß©¥©¥©¥©ß©ß©¥©¥©¥©ß©¥
